PALAVRA= Unidade da lingua escrita
FADA= Ser do mundo da fantasia
AMOR= Sentimentos
ARMARIO= Guarda objetos
TELEVISAO= Aparelho para assistir programas
VENTILADOR= Faz diferenca no calor
CUECA= Roupas de baixo
VASO= Utilizado pelas plantas
TELEFONE= Aparelho para falar com outra pessoa
MESA= Moveis de casa
BLUSA= Roupas
PERFUME= Que cheiro bom
CHULE= Que cheiro ruim
CALCA= Roupas
TRAVESSEIRO= Para dormir
CREME= Vamos passar no rosto
VASO= Pote para flores
PREGADOR= Segura as roupas na corda
GRADE= ladr√£o fica atras dela
JANELA= abra e veja o sol
TAPETE= estenda no chao
ESCOVA= Usa nos dentes
BANCO= Tem na pracinha
CADEIRA= Vai sentar na ...
FOTOGRAFIA= Forma de recordar
LUMINARIA= Coloque a lampada na ...
COPO= Usado para beber
CANECA= xicara grande
CELULAR= O mesmo que smartfone
CORTADOR= Usa para cortar
ALICATE= Ferramenta de eletricista
CHINELO= Usado nos pes
CORUJA= Ave noturna
VIDRO= Eh transparente e tem na janela
PLASTICO= Material de garrafa pet
MALA= Bolsa usada em viagens
PANELA= Utensilho para cozinhar
PIA= Tem no banheiro e na cozinha
GELADEIRA= Usado para refrigerar comida
FOGAO= Eletrodomestico para cozinhar
PORTA= Possui fechadura
CHUVEIRO= Para tomar banho
REDE= Na Bahia usa-se como cama
TOMADA= Usado para ligar coisas eletronicas
POTE= O mesmo que jarro
CHALEIRA= Onde se faz cha
JARRA= Usa-se para fazer suco
ALGODAO= Material fofinho para limpar maquiagem
CABIDE= Usa-se para pendurar roupas
